0 0 0 0 0 0 0 0 3 1 2 0 0 0 0 0 0 0 0
0 0 0 0 0 0 0 0 3 1 2 0 0 0 0 0 0 0 0
0 0 0 0 0 0 0 0 3 1 2 0 0 0 0 0 0 0 0
0 0 0 0 0 0 0 0 0 1 0 0 0 0 0 0 0 0 0
0 0 0 0 0 0 0 0 0 1 0 0 0 0 0 0 0 0 0
4 4 4 0 0 0 0 0 0 1 0 0 0 0 0 0 4 4 4
1 1 1 1 1 1 1 1 1 1 1 1 1 1 6 7 1 1 1
5 5 5 0 0 0 0 0 0 1 0 0 0 0 0 0 5 5 5
0 0 0 0 0 0 0 0 0 1 0 0 0 0 0 0 0 0 0
0 0 0 0 0 0 0 0 0 1 0 0 0 0 0 0 0 0 0
0 0 0 0 0 0 0 0 3 6 2 0 0 0 0 0 0 0 0
0 0 0 0 0 0 0 0 3 1 2 0 0 0 0 0 0 0 0
0 0 0 0 0 0 0 0 3 1 2 0 0 0 0 0 0 0 0