1 1 1 1 1 1 1 1 1 31 1 1 1 1 1 1 1 1 1
1 1 0 0 0 1 1 0 0 0 1 1 1 1 1 1 1 1 1
1 1 6 6 0 1 1 0 1 0 1 1 1 1 1 1 1 1 1
1 1 0 0 0 1 1 0 1 0 1 1 1 1 1 1 1 1 1
1 1 0 6 6 1 1 0 1 0 1 1 1 1 1 1 1 1 1
1 1 0 0 0 1 1 0 0 0 1 1 1 1 1 1 1 1 1
1 1 1 1 1 1 1 1 1 1 1 1 1 1 1 1 1 1 1
1 1 1 1 1 1 1 1 1 1 1 1 1 1 1 1 1 1 1
1 1 1 1 1 1 1 1 1 1 1 1 1 1 1 1 1 1 1
1 1 1 1 1 1 1 1 1 1 1 1 1 1 1 1 1 1 1
1 1 1 1 1 1 1 1 1 1 1 1 1 1 1 1 1 1 1
1 1 1 1 1 1 1 1 1 1 1 1 1 1 1 1 1 1 1
1 1 1 1 1 1 1 1 1 40 1 1 1 1 1 1 1 1 1