0 0 0 0 0 0 0 0 0 0 0 0 0 0 0 0 0 0 0
0 0 0 0 0 0 0 0 0 0 0 0 0 0 0 0 0 0 0
0 0 0 0 0 0 0 0 0 0 0 0 0 0 0 0 0 0 0
0 0 0 0 0 3 4 4 4 4 4 4 4 2 0 0 0 0 0
0 0 0 0 0 3 1 1 1 1 6 7 8 2 0 0 0 0 0
4 4 4 4 4 1 1 1 1 1 1 1 1 1 4 4 4 4 4
1 1 1 1 1 1 1 1 1 1 1 1 1 1 1 1 1 1 1
5 5 5 5 5 1 1 1 1 6 1 1 1 1 5 5 5 5 5
0 0 0 0 0 3 1 1 1 7 6 7 8 2 0 0 0 0 0
0 0 0 0 0 3 5 5 5 5 5 5 5 3 0 0 0 0 0
0 0 0 0 0 0 0 0 0 0 0 0 0 0 0 0 0 0 0
0 0 0 0 0 0 0 0 0 0 0 0 0 0 0 0 0 0 0
0 0 0 0 0 0 0 0 0 0 0 0 0 0 0 0 0 0 0