0 0 0 0 0 0 0 3 1 31 1 2 0 0 0 0 0 0 0
0 0 0 0 0 0 0 3 1 1 6 2 0 0 0 0 0 0 0
0 0 0 0 0 0 0 3 1 1 7 2 0 0 0 0 0 0 0
0 0 0 0 0 0 0 3 1 1 1 2 0 0 0 0 0 0 0
0 0 0 0 0 0 0 3 8 1 1 2 0 0 0 0 0 0 0
0 0 0 0 0 0 0 3 1 1 1 2 0 0 0 0 0 0 0
0 0 0 0 0 0 0 3 1 1 1 2 0 0 0 0 0 0 0
0 0 0 0 0 0 0 3 1 1 1 2 0 0 0 0 0 0 0
0 0 0 0 0 0 0 3 1 1 1 2 0 0 0 0 0 0 0
0 0 0 0 0 0 0 3 1 1 1 2 0 0 0 0 0 0 0
0 0 0 0 0 0 0 3 1 1 1 2 0 0 0 0 0 0 0
0 0 0 0 0 0 0 3 1 1 1 2 0 0 0 0 0 0 0
0 0 0 0 0 0 0 3 1 1 1 2 0 0 0 0 0 0 0